// 使用 "//" 放在行首可以跳过该行，可在其后写上注释
internet of things==iot==internet of thing==internet-of-things
distributed ledger==distributed ledger technology==dlt==distribute ledger technology==distribute ledger==distribute==ledger
blockchain==block chain==block-chain==bc-blockchain==blockchains
proof-of-work==pow==proof of work
proof-of-stake==pos==proof of stake
consensus protocol==proof-of-work==consensus algorithm==consensus==consensus mechanism
peer-to-peer==peer-to-peer compute==p2p==peer to peer==peer-2-peer
zero-knowledge proof==zero-knowledge-proof==zero knowledge proof==zkp==zero-knowledge
e-health==ehealth==e-healthcare
cyberattack==cyber attack==cyber-attack
industrial iot==iiot
supply chain==supplychain==supply chain management
industry==industry 4.0==industry 40==i4.0
cryptography==key
healthcare==health care
bitcoin==bit coin
contract==smart contract==smart-contract
cryptocurrency==crypto currency==cryptocurrencies
review==literature review==systematic literature review==systematic review
vote-based consensus==vote==voting-based==vote-based
proof-based consensus==proof-based
dapp==dapps
artificial intelligence==ai
encryption==encryption algorithm
cyber attack==cyberattack==network attack
security==cyber security==cybersecurity==network security
deep learning==deep learn
machine learning==machine learn
byzantine fault tolerance==byzantine fault==byzantine fault tolerant consensus==byzantine fault-tolerant
crash fault tolerance==crash fault tolerant consensus
mining pool==mine pool==bitcoin mine pool
double spending==double spend problem
cloud compute==cloud
threat==security threat
database==distribute database
network==network property====peer-to-peer
attack==51% attack==51 attack==double spend attack==double spend==sybil attack==cyber attack==cyberattack==cyberattacks
security==economics of security==application security==secure element==software security==software security engineer==information security==system security==distribute system security
digital signature==ring signature==type signature==multi-signature aggregation
cryptography==hash function==digital signature
formal approach==formal method==formal verification==verification
mine==mining pool==selfish mine
// 可使用 nothing 代替准备去掉的话题词，如 blockchain，review，tutorial 等等
// 建议将 nothing 这一行放到最后一行
nothing==distributed ledger==requirement==vulnerability==software==architecture==algorithm==human and societal aspect of security and privacy==review==security==blockchain==NaN==r==eh==tx==tc==1.0==2.0==60g40==68m01==91a60==99-00==g18==c58==c63
